0000000000000000000000000000
0000000000000000000000000000
0000000000000000000000000000
0061111111111561111111111150
0028778888777227777777777720
0027657611157227611157611520
0027227200027227200027200220
0027437411137437411137411320
0027777777777777777777777720
0027777657611111157657615720
0027777227411561137227413720
002777722787743w777227777720
0028877436157777611327611520
0027787654137777411527200220
002977722787i7a7877227200220
0027777227611111157227200220
002777743p200000027437411320
0028777777200000027777777720
0027777657411111137657611130
0027777227777777777227200000
0027777227777p77777227200000
0027777227611111157227200000
0027777437411561137437411150
0027658777777227c78878611520
0027437611157437611157411320
0027777411137777411137778820
0041111111111111111111111130
0000000000000000000000000000
0000000000000000000000000000
0000000000000000000000000000
0000000000000000000000000000
0000000000000000000000000000
0000000000000000000000000000
0000000000000000000000000000
0000000000000000000000000000
0000000000000000000000000000